0,6,0,1,2,3
0,6,5,4,0,0
0,6,6,3,2,0
0,0,1,1,1,0
0,1,0,1,0,1